------

TODAY'S NEWSPAPER FRONT PAGE

A Surprising New Leader

In a shocking last minute swing, the country voted for a candidate who, only days ago, looked to be almost totally unelectable. The candidate only recently entered politics and has now led a fringe party to power. A party which has never previously garnered more than a few percent of the vote.

Politics isn't what it once was. These are volatile times and the people are eager for a leader who can change things. It's not clear what the voters want - it's not even clear that *they* know what they want - but it's clear the status quo is not it.

Thanks to his landslide victory, the new Head of State currently has a political power of 5/5 stars, according to our new rating. Be sure to follow this number throughout his sure-to-be "exciting" tenure!

------

You stand looking out of the window.

So here we are. You are the new Head of State who has had a meteoric rise to the highest office in the land, but the will of the people is a fickle thing, and you are no run-of-the-mill politican. Scandals are popping up left, right and centre; your staff are leaking damaging comments; the established parties hate you; the media is lapping it up.

You're going to have to work hard if you want to stay in power: It's already beginning to slip through your fingers...

Head of State
An Interactive Fiction by Tom Davies
Release 1 / Serial number 170730 / Inform 7 build 6M62 (I6/v6.33 lib 6/12N) SD

Official Office
Your office probably doesn't look much different now to how it did when each of your predecessors occupied it over the last century.

Portraits of stern old white men hang on the walls, a huge chandelier hangs down from the ceiling the the middle of the room. A huge dark wooden desk sits in front of your chair.

The things some men have done to make it to this room...

Your senior advisor, Martin Gavell, stands patiently in front of your desk. It looks like he's waiting for you to speak to him.

I beg your pardon?

I beg your pardon?

>examine room
You can't see any such thing.

>examine desk
Heavy and ancient. Clearly well used, but in fantastic condition nonetheless.

* * *

>check political power
You can't see any such thing.

* * *

>examine Gavell
Gavell is your right-hand man. He's loyal and he knows how to keep his mouth shut.

>talk to Gavell
You nod to Gavell.

Gavell: "Sir, the healthcare bill requires your attention."

1) Just grunt.
2) Ask for the bill.

>1
[Just grunt.]

You grunt to indicate that he can continue.

Gavell: "Here you are, Sir."

Gavell gives the bill to you.

Official Office
Your office probably doesn't look much different now to how it did when each of your predecessors occupied it over the last century.

Portraits of stern old white men hang on the walls, a huge candelier hangs down from the ceiling the the middle of the room. A huge dark wooden desk sits in front of your chair.

The things some men have done to make it to this room...

Your senior advisor, Martin Gavell, stands patiently in front of your desk.

>inventory
You are carrying:
  a healthcare bill

* * *

>examine Gravell
Gravell is your right-hand man. He's loyal and he knows how to keep his mouth shut.

You nod to Gravell.

Gravell: "Sir, the healthcare bill requires your attention"

1) Just grunt.
2) Ask him to leave it on your desk.

>1
[Just grunt.]

You grunt to indicate that he can continue.

Gravell: "Very good, Sir."

Official Office
Your office probably doesn't look much different now to how it did when each of your predecessors occupied it over the last century.

Portraits of stern old white men hang on the walls, a huge candelier hangs down from the ceiling the the middle of the room. A huge dark wooden desk sits in front of your chair.

The things some men have done to make it to this room...

On the desk is Now the bill.

Your senior advisor, Martin Gravell, stands patiently in front of your desk.

* * *

>examine Gravell
Gravell is your right-hand man. He's loyal and he knows how to keep his mouth shut.

You nod to Gravell.

Gravell: "Sir, the healthcare bill requires your attention"

1) Just grunt.
2) Ask him to leave it on your desk.

>2
[Ask him to leave it on your desk.]

You: "Leave it on my desk, Gravell."

1)

I beg your pardon?

>1
[]

Gravell: "Very good, Sir."

You: "Leave it on my desk, Gravell."

1)

* * *

>examine Martin
Gravell is your right-hand man. He's loyal and he knows how to keep his mouth shut.

You nod to Gravell.

Gravell: "Sir, the healthcare bill requires your attention"

1) Just grunt.
2) Ask him to leave it on your desk.

>1
[Just grunt.]

You grunt to indicate that he can continue.

Gravell: "Very good, Sir."

Gravell carefully places the bill on your desk.

Official Office
Your office probably doesn't look much different now to how it did when each of your predecessors occupied it over the last century.

Portraits of stern old white men hang on the walls, a huge candelier hangs down from the ceiling the the middle of the room. A huge dark wooden desk sits in front of your chair.

The things some men have done to make it to this room...

Your senior advisor, Martin Gravell, stands patiently in front of your desk.

>examine desk
Heavy and ancient. Clearly well used, but in fantastic condition nonetheless.

>examine bill
You can't see any such thing.

* * *

>examine Martin
Gravell is your right-hand man. He's loyal and he knows how to keep his mouth shut.

You nod to Gravell.

Gravell: "Sir, the healthcare bill requires your attention"

1) Just grunt.
2) Ask him to leave it on your desk.

>2
[Ask him to leave it on your desk.]

You: "Leave it on my desk, Gravell."

Gravell: "Very good, Sir."

Official Office
Your office probably doesn't look much different now to how it did when each of your predecessors occupied it over the last century.

Portraits of stern old white men hang on the walls, a huge candelier hangs down from the ceiling the the middle of the room. A huge dark wooden desk sits in front of your chair.

The things some men have done to make it to this room...

On the desk is now the bill.

Your senior advisor, Martin Gravell, stands patiently in front of your desk.

* * *

>examine advisor
Gravell is your right-hand man. He's loyal and he knows how to keep his mouth shut.

You nod to Gravell.

Gravell: "Sir, the healthcare bill requires your attention."

1) Just grunt.
2) Ask for the bill.

>1
[Just grunt.]

You grunt to indicate that he can continue.

Gravell: "Here you are, Sir."

Gravell gives the bill to you.

Official Office
Your office probably doesn't look much different now to how it did when each of your predecessors occupied it over the last century.

Portraits of stern old white men hang on the walls, a huge candelier hangs down from the ceiling the the middle of the room. A huge dark wooden desk sits in front of your chair.

The things some men have done to make it to this room...

Your senior advisor, Martin Gravell, stands patiently in front of your desk.

* * *

>examine bill
It's an offical document. A bill that needs your approval if it is to survive. Something about funding for healthcare for the poorest and most needy citizens of this great country: Not something you are known for supporting.

>examine Martin
Gravell is your right-hand man. He's loyal and he knows how to keep his mouth shut.

You nod to Gravell.

Gravell: "Sir, the healthcare bill requires your attention"

1) Just grunt.
2) Ask him to leave it on your desk.

>2
[Ask him to leave it on your desk.]

You: "Leave it on my desk, Gravell."

Gravell: "Very good, Sir."

Gravell carefully places the bill on your desk.

Official Office
Your office probably doesn't look much different now to how it did when each of your predecessors occupied it over the last century.

Portraits of stern old white men hang on the walls, a huge candelier hangs down from the ceiling the the middle of the room. A huge dark wooden desk sits in front of your chair.

The things some men have done to make it to this room...

Your senior advisor, Martin Gravell, stands patiently in front of your desk.

>examine bill
You can't see any such thing.

>examine desk
Heavy and ancient. Clearly well used, but in fantastic condition nonetheless.

* * *

>examine gravell
Gravell is your right-hand man. He's loyal and he knows how to keep his mouth shut.

You nod to Gravell.

Gravell: "Sir, the healthcare bill requires your attention."

1) Just grunt.
2) Ask for the bill.

I beg your pardon?

* * *

>examine gravell
Gravell is your right-hand man. He's loyal and he knows how to keep his mouth shut.

You nod to Gravell.

Gravell: "Sir, the healthcare bill requires your attention."

1) Just grunt.
2) Ask for the bill.

>1
[Just grunt.]

You grunt to indicate that he can continue.

Gravell: "Very good, Sir."

You nod to Gravell.

Gravell: "Sir, the healthcare bill requires your attention"

1) Just grunt.
2) Ask him to leave it on your desk.

* * *

>examine gravell
Gravell is your right-hand man. He's loyal and he knows how to keep his mouth shut.

You nod to Gravell.

Gravell: "Sir, the healthcare bill requires your attention."

1) Just grunt.
2) Ask for the bill.

>2
[Ask for the bill.]

You: "Hand it over, Gravell."

Gravell: "Here you are, Sir."

Gravell gives the bill to you.

Official Office
Your office probably doesn't look much different now to how it did when each of your predecessors occupied it over the last century.

Portraits of stern old white men hang on the walls, a huge candelier hangs down from the ceiling the the middle of the room. A huge dark wooden desk sits in front of your chair.

The things some men have done to make it to this room...

Your senior advisor, Martin Gravell, stands patiently in front of your desk.

>examine bill
It's an offical document. A bill that needs your approval if it is to survive. Something about funding for healthcare for the poorest and most needy citizens of this great country: Not something you are known for supporting.

>sign bill
I didn't understand that sentence.

* * *

>examine gravell
Gravell is your right-hand man. He's loyal and he knows how to keep his mouth shut.

You nod to Gravell.

Gravell: "Sir, the healthcare bill requires your attention."

1) Just grunt.
2) Ask for the bill.

>look at gravell
Gravell is your right-hand man. He's loyal and he knows how to keep his mouth shut.

>examine the bill
It's an offical document. A bill that needs your approval if it is to survive. Something about funding for healthcare for the poorest and most needy citizens of this great country: Not something you are known for supporting.

* * *

>examine kletter
You can't see any such thing.

>examine letter
An offical document. A bill that needs your approval if it is to survive. Something about funding for healthcare for the poor: Not something you are known for supporting.

* * *

>examine martin
Gravell is your right-hand man. He's loyal and he knows how to keep his mouth shut.

You nod to Gravell.

Gravell: "Sir, the healthcare bill requires your attention"

1) Just grunt.
2) Ask him to leave it on your desk.

I beg your pardon?

* * *

>examine martin
Gravell is your right-hand man. He's loyal and he knows how to keep his mouth shut.

You nod to Gravell.

Gravell: "Sir, the healthcare bill requires your attention"

1) Just grunt.
2) Ask him to leave it on your desk.

>1
[Just grunt.]

You grunt to indicate that he can continue.

Gravell: "Very good, Sir."

Gravell carefully places the bill on your desk.

Official Office
Your office probably doesn't look much different now to how it did when each of your predecessors occupied it over the last century.

Portraits of stern old white men hang on the walls, a huge candelier hangs down from the ceiling the the middle of the room. A huge dark wooden desk sits in front of your chair.

The things some men have done to make it to this room...

Your senior advisor, Martin Gravell, stands patiently in front of your desk.

>examine bill
You can't see any such thing.

* * *

>inventory
You are carrying:
  a bill

* * *

>examine martin
Gravell is your right-hand man. He's loyal and he knows how to keep his mouth shut.

You nod to Gravell.

Gravell: "Sir, the healthcare bill requires your attention"

1) Just grunt.
2) Ask him to leave it on your desk.

>2
[Ask him to leave it on your desk.]

You: "Leave it on my desk, Gravell."

Gravell: "Very good, Sir."

Gravell carefully places the bill on your desk.

Official Office
Your office probably doesn't look much different now to how it did when each of your predecessors occupied it over the last century.

Portraits of stern old white men hang on the walls, a huge candelier hangs down from the ceiling the the middle of the room. A huge dark wooden desk sits in front of your chair.

The things some men have done to make it to this room...

Your senior advisor, Martin Gravell, stands patiently in front of your desk.

>examine des
You can't see any such thing.

>examine desk
Heavy and ancient. Clearly well used, but in fantastic condition nonetheless.

* * *

>examine martin gravell
Gravell is your right-hand man. He's loyal and he knows how to keep his mouth shut.

* * *

>examine my advisor
You can't see any such thing.

>examine advisor
You can't see any such thing.

* * *

>examine myself
A droopy face, too much makeup, a bit on the heavy side. Not that you are willing to acknowledge any of the negatives. You're important. You've always been important. If someone disagrees with you they must be wrong - and your expression shows it.

>look at myself
A droopy face, too much makeup, a bit on the heavy side. Not that you are willing to acknowledge any of the negatives. You're important. You've always been important. If someone disagrees with you they must be wrong - and your expression shows it.

* * *

>examine painting
These are the people who led this country since its foundation over one hundred years ago. I'm better and smarter than them.

>examine Gravell
Gravell is your right-hand man. He's loyal and he knows how to keep his mouth shut.

You nod to Gravell.

Gravell: "Sir, the healthcare bill requires your attention"

1) Just grunt.
2) Ask him to leave it on your desk.

>1
[Just grunt.]

You grunt to indicate that he can continue.

1)

* * *

>examine portait
You can't see any such thing.

>examine portait
You can't see any such thing.

>examine portaits
These are the people who led this country since its foundation over one hundred years ago. I'm better and smarter than them.

* * *

>examine portrait
These are the people who led this country since its foundation over one hundred years ago. I'm better and smarter than them.

* * *

>examine self
A droopy face, too much makeup, a bit on the heavy side. Not that you are willing to acknowledge any of the negatives. You're important. You've always been important. If someone disagrees with you they must be wrong - and your expression makes that clear.

>examine martin
Gravell is your right-hand man. He's loyal and he knows how to keep his mouth shut.

You nod to Gravell.

Gravell: "Sir, the healthcare bill requires your attention"

1) Just grunt.
2) Ask him to leave it on your desk.

* * *

>examine selse
You can't see any such thing.

>examine self
A droopy face, too much makeup, a bit on the heavy side. Not that you are willing to acknowledge any of the negatives. You're important. You've always been important. If someone disagrees with you they must be wrong - and your expression makes that clear.

* * *

>examine the bill
It's an offical document. A bill that needs your approval if it is to survive. Something about funding for healthcare for the poorest and most needy citizens of this great country: Not something you are known for supporting.

* * *

>help
Official Office
Your office probably doesn't look much different now to how it did when each of your predecessors occupied it over the last century.

Portraits of stern old white men hang on the walls, a huge candelier hangs down from the ceiling the the middle of the room. A huge dark wooden desk sits in front of your chair.

The things some men have done to make it to this room...

Your senior advisor, Martin Gavell, stands patiently in front of your desk. It looks like he's waiting for you to speak to him.

>hints
Official Office
Your office probably doesn't look much different now to how it did when each of your predecessors occupied it over the last century.

Portraits of stern old white men hang on the walls, a huge candelier hangs down from the ceiling the the middle of the room. A huge dark wooden desk sits in front of your chair.

The things some men have done to make it to this room...

Your senior advisor, Martin Gavell, stands patiently in front of your desk. It looks like he's waiting for you to speak to him.

* * *

>info
 > Introduction to Head of State
   Instructions for Play
 > Introduction to Head of State
   Instructions for Play

* * *

>look at gravell
Gravell is your right-hand man. He's loyal and he knows how to keep his mouth shut.

You nod to Gravell.

Gravell: "Sir, the healthcare bill requires your attention"

1) Just grunt.

>1
[Just grunt.]

You grunt to indicate that he can continue.

>0
There is no choice corresponding to that number.

* * *

>sign bill
That would just be graffiti.

* * *

>sign the bill
Why would I do that?

>take bill
That seems to belong to Martin Gavell.

>speak to Gavell
You nod to Gavell.

Gavell: "Sir, the healthcare bill requires your attention."

1) Just grunt.
2) Ask for the bill.

>1
[Just grunt.]

You grunt to indicate that he can continue.

Gavell: "Here you are, Sir."

Gavell gives the bill to you.

Official Office
Your office probably doesn't look much different now to how it did when each of your predecessors occupied it over the last century.

Portraits of stern old white men hang on the walls, a huge candelier hangs down from the ceiling the the middle of the room. A huge dark wooden desk sits in front of your chair.

The things some men have done to make it to this room...

Your senior advisor, Martin Gavell, stands patiently in front of your desk.

* * *

>speak to Gavell
You nod to Gavell.

Gavell: "Sir, the healthcare bill requires your attention."

1) Just grunt.
2) Ask for the bill.

>2
[Ask for the bill.]

You: "Hand it over, Gavell."

Gavell: "Here you are, Sir."

Gavell gives the bill to you.

Official Office
Your office probably doesn't look much different now to how it did when each of your predecessors occupied it over the last century.

Portraits of stern old white men hang on the walls, a huge candelier hangs down from the ceiling the the middle of the room. A huge dark wooden desk sits in front of your chair.

The things some men have done to make it to this room...

Your senior advisor, Martin Gavell, stands patiently in front of your desk.

>examine bill
It's an offical document. A bill that needs your approval if it is to survive. Something about funding for healthcare for the poorest and most needy citizens of this great country: Not something you are known for supporting.

* * *

>speak to gavell
You nod to Gavell.

Gavell: "Sir, the healthcare bill requires your attention."

1) Just grunt.
2) Ask for the bill.

>2
[Ask for the bill.]

You: "Hand it over, Gavell."

Gavell: "Here you are, Sir."

Gavell gives the bill to you.

Official Office
Portraits of stern old white men hang on the walls, a huge candelier hangs down from the ceiling the the middle of the room. A huge dark wooden desk sits in front of your chair.

Your senior advisor, Martin Gavell, stands patiently in front of your desk.

* * *

>speak to martin
You nod to Gavell.

Gavell: "Sir, the healthcare bill requires your attention."

1) Just grunt.
2) Ask for the bill.

>ยง
That command isn't available in choice mode.

>1
[Just grunt.]

You grunt to indicate that he can continue.

Gavell: "Here you are, Sir."

Gavell gives the bill to you.

Official Office
Your office probably doesn't look much different now to how it did when each of your predecessors occupied it over the last century.

Portraits of stern old white men hang on the walls, a huge candelier hangs down from the ceiling the the middle of the room. A huge dark wooden desk sits in front of your chair.

The things some men have done to make it to this room...

Your senior advisor, Martin Gavell, stands patiently in front of your desk.

>destroy desk
Violence isn't the answer to this one.

* * *

>take desk
That's hardly portable.

* * *

>talk martin
I didn't understand that sentence.

>talk to martin
You nod to Gavell.

Gavell: "Sir, the healthcare bill requires your attention."

1) Just grunt.
2) Ask for the bill.

>1
[Just grunt.]

You grunt to indicate that he can continue.

Gavell: "Here you are, Sir."

Gavell gives the bill to you.

Official Office
Your office probably doesn't look much different now to how it did when each of your predecessors occupied it over the last century.

Portraits of stern old white men hang on the walls, a huge candelier hangs down from the ceiling the the middle of the room. A huge dark wooden desk sits in front of your chair.

The things some men have done to make it to this room...

Your senior advisor, Martin Gavell, stands patiently in front of your desk.

>eat bill
You momentarily pause as you decide exactly what to do."

Gavell: "This won't go down well with the voters, SIr." You: "FUCK the voters.""

* * *

>talk to gavell
You nod to Gavell.

Gavell: "Sir, the healthcare bill requires your attention."

1) Just grunt.
2) Ask for the bill.

>1
[Just grunt.]

You grunt to indicate that he can continue.

Gavell: "Here you are, Sir."

Gavell gives the bill to you.

Official Office
Portraits of stern old white men hang on the walls, a huge candelier hangs down from the ceiling the the middle of the room. A huge dark wooden desk sits in front of your chair.

Your senior advisor, Martin Gavell, stands patiently in front of your desk.

You have possession of the healthcare bill.

>eat the bill
You momentarily pause as you decide exactly what you want to do.

1) Reject the bill.
2) Destroy the bill.
3) Destroy the bill with extreme prejudice.

>3
...and spit on it.

[Press any key]

* * *

>1
[Just grunt.]

You grunt to indicate that he can continue.

Gavell: "Here you are, Sir."

Gavell gives the bill to you.

Official Office
Portraits of stern old white men hang on the walls, a huge candelier hangs down from the ceiling the the middle of the room. A huge dark wooden desk sits in front of your chair.

Your senior advisor, Martin Gavell, stands patiently in front of your desk.

You have possession of the healthcare bill.

>examine bill
A bill that needs your approval if it is to survive. Something about funding for healthcare for the poorest and most needy citizens of this great country: Not something you are known for supporting.

A space has been left for your signature below the body of the document.

>sign the bill
You sign the bill into law and an aid takes it away for safe keeping.

>undo
Official Office
[Previous turn undone.]

>eat the bill
You momentarily pause as you decide exactly what you want to do.

1) Reject the bill.
2) Destroy the bill.
3) Destroy the bill with extreme prejudice.

>3
Gavell: "This won't go down well with the voters, Sir."

You: "FUCK the voters."

Official Office
Portraits of stern old white men hang on the walls, a huge candelier hangs down from the ceiling the the middle of the room. A huge dark wooden desk sits in front of your chair.

Your senior advisor, Martin Gavell, stands patiently in front of your desk.

* * *

>1
[Just grunt.]

You grunt to indicate that he can continue.

Gavell: "Here you are, Sir."

Gavell gives the bill to you.

Official Office
Portraits of stern old white men hang on the walls, a huge candelier hangs down from the ceiling the the middle of the room. A huge dark wooden desk sits in front of your chair.

Your senior advisor, Martin Gavell, stands patiently in front of your desk.

You have possession of the healthcare bill.

>sign the bill
------

TODAY'S NEWSPAPER FRONT PAGE

Notable Healthcare Bill Passes

In a surprising move, the country's new leader has passed the much debated healthcare bill. The passing of the bill has been welcomed by many opposing politicians, however there seems to be some dissatisfaction from the premier's core voter base.

The shaking of the foundations of the Head of State's support has taken its toll. According to our latest calculations, his political power has sunk to 5/5 stars, moreover, his latest actions have raised questions around what this man really stands for.

------

I beg your pardon?

* * *

>talk to gavell
You nod to Gavell.

Gavell: "Sir, the healthcare bill requires your attention."

1) Just grunt.
2) Ask for the bill.

>2
[Ask for the bill.]

You: "Hand it over, Gavell."

Gavell: "Here you are, Sir."

Gavell gives the bill to you.

Official Office
Portraits of stern old white men hang on the walls, a huge candelier hangs down from the ceiling the the middle of the room. A huge dark wooden desk sits in front of your chair.

Your senior advisor, Martin Gavell, stands patiently in front of your desk.

You have possession of the healthcare bill.

>talk to gavell
Gavell: "You need to decide what to do with the healthcare bill, Sir."

>sign the bill
You sign the bill into law and an aid takes it away for safe keeping.

>undo examine the bill
I didn't understand that sentence.

* * *

>talk to martin
You nod to Gavell.

Gavell: "Sir, the healthcare bill requires your attention."

1) Just grunt.
2) Ask for the bill.

>1
[Just grunt.]

You grunt to indicate that he can continue.

Gavell: "Here you are, Sir."

Gavell gives the bill to you.

Official Office
Portraits of stern old white men hang on the walls, a huge candelier hangs down from the ceiling the the middle of the room. A huge dark wooden desk sits in front of your chair.

Your senior advisor, Martin Gavell, stands patiently in front of your desk.

You have possession of the healthcare bill.

I beg your pardon?

>eat bill
You momentarily pause as you decide exactly what you want to do.

1) Reject the bill.
2) Destroy the bill.
3) Destroy the bill with extreme prejudice.

>1
[Reject the bill.]

You refuse to sign the bill and tell your aide to inform the relevant people.

Gavell: "This won't go down well with the liberals, SIr." You: "I don't care about the liberals""

Official Office
Your office probably doesn't look much different now to how it did when each of your predecessors occupied it over the last century.

Portraits of stern old white men hang on the walls, a huge candelier hangs down from the ceiling the the middle of the room. A huge dark wooden desk sits in front of your chair.

The things some men have done to make it to this room...

Your senior advisor, Martin Gavell, stands patiently in front of your desk.

>undo
Official Office
[Previous turn undone.]

>eat bill
That command isn't available in choice mode.

>2
[Destroy the bill.]

You mutter "absolute garbage" as you rip up the bill and throw it away.

Gavell: "This won't go down well with the liberals, SIr." You: "I don't care about the liberals""

Official Office
Your office probably doesn't look much different now to how it did when each of your predecessors occupied it over the last century.

Portraits of stern old white men hang on the walls, a huge candelier hangs down from the ceiling the the middle of the room. A huge dark wooden desk sits in front of your chair.

The things some men have done to make it to this room...

Your senior advisor, Martin Gavell, stands patiently in front of your desk.

>undo
Official Office
[Previous turn undone.]

>3
and spit on it
Gavell: "This won't go down well with the voters, SIr." You: "FUCK the voters.""

Official Office
Your office probably doesn't look much different now to how it did when each of your predecessors occupied it over the last century.

Portraits of stern old white men hang on the walls, a huge candelier hangs down from the ceiling the the middle of the room. A huge dark wooden desk sits in front of your chair.

The things some men have done to make it to this room...

Your senior advisor, Martin Gavell, stands patiently in front of your desk.

* * *

>1
[Just grunt.]

You grunt to indicate that he can continue.

Gavell: "Here you are, Sir."

Gavell gives the bill to you.

Official Office
Portraits of stern old white men hang on the walls, a huge candelier hangs down from the ceiling the the middle of the room. A huge dark wooden desk sits in front of your chair.

Your senior advisor, Martin Gavell, stands patiently in front of your desk.

You have possession of the healthcare bill.

>destroy the bill
Violence isn't the answer to this one.

>eat the bill
You momentarily pause as you decide exactly what you want to do.

1) Reject the bill.
2) Destroy the bill.
3) Destroy the bill with extreme prejudice.

>1
[Reject the bill.]

You refuse to sign the bill and tell your aide to inform the relevant people.

Gavell: "This won't go down well with the house, Sir."

You: "I don't care about the house"

Official Office
Portraits of stern old white men hang on the walls, a huge candelier hangs down from the ceiling the the middle of the room. A huge dark wooden desk sits in front of your chair.

Your senior advisor, Martin Gavell, stands patiently in front of your desk.

>undo
Official Office
[Previous turn undone.]

>3
Gavell: "This won't go down well with the voters, Sir."

You: "FUCK the voters."

Official Office
Portraits of stern old white men hang on the walls, a huge candelier hangs down from the ceiling the the middle of the room. A huge dark wooden desk sits in front of your chair.

Your senior advisor, Martin Gavell, stands patiently in front of your desk.

* * *

>1
[Just grunt.]

You grunt to indicate that he can continue.

Gavell: "Here you are, Sir."

Gavell gives the bill to you.

Official Office
Portraits of stern old white men hang on the walls, a huge candelier hangs down from the ceiling the the middle of the room. A huge dark wooden desk sits in front of your chair.

Your senior advisor, Martin Gavell, stands patiently in front of your desk.

You have possession of the healthcare bill.

>eat bill
You momentarily pause as you decide exactly what you want to do.

1) Reject the bill.
2) Destroy the bill.
3) Destroy the bill with extreme prejudice.

>3
Gavell: "This won't go down well with the voters, SIr."

You: "FUCK the voters."

Official Office
Your office probably doesn't look much different now to how it did when each of your predecessors occupied it over the last century.

Portraits of stern old white men hang on the walls, a huge candelier hangs down from the ceiling the the middle of the room. A huge dark wooden desk sits in front of your chair.

The things some men have done to make it to this room...

Your senior advisor, Martin Gavell, stands patiently in front of your desk.

* * *

>1
[Just grunt.]

You grunt to indicate that he can continue.

Gavell: "Here you are, Sir."

Gavell gives the bill to you.

Official Office
Portraits of stern old white men hang on the walls, a huge candelier hangs down from the ceiling the the middle of the room. A huge dark wooden desk sits in front of your chair.

Your senior advisor, Martin Gavell, stands patiently in front of your desk.

You have possession of the healthcare bill.

>examine office
You can't see any such thing.

>examine official office
You can't see any such thing.

>examine room
You can't see any such thing.

>look around
You can't see any such thing.

* * *

>1
[Just grunt.]

You grunt to indicate that he can continue.

Gavell: "Here you are, Sir."

Gavell gives the bill to you.

Official Office
Portraits of stern old white men hang on the walls, a huge candelier hangs down from the ceiling the the middle of the room. A huge dark wooden desk sits in front of your chair.

Your senior advisor, Martin Gavell, stands patiently in front of your desk.

You have possession of the healthcare bill.

>inventory
You are carrying:
  a healthcare bill

>eat bill
You momentarily pause as you decide exactly what you want to do.

Gavell: "This won't go down well with the voters, SIr." You: "FUCK the voters.""

* * *

>1
[Just grunt.]

You grunt to indicate that he can continue.

Gavell: "Here you are, Sir."

Gavell gives the bill to you.

Official Office
Portraits of stern old white men hang on the walls, a huge candelier hangs down from the ceiling the the middle of the room. A huge dark wooden desk sits in front of your chair.

Your senior advisor, Martin Gavell, stands patiently in front of your desk.

You have possession of the healthcare bill.

>sign bill
------

TODAY'S NEWSPAPER FRONT PAGE

Notable Healthcare Bill Passes

In a surprising move, the country's new leader has passed the much debated healthcare bill. The passing of the bill has been welcomed by many opposing politicians, however there seems to be some dissatisfaction from the premier's core voter base.

The shaking of the foundations of the Head of State's support has taken its toll. According to our latest calculations, his political power has dipped to 4/5 stars, moreover, his latest actions have raised questions around what this man really stands for. Perhaps this recent change of heart is the beginning of something much greater. Only time will tell.

------

I beg your pardon?

* * *

>examine room
You can't see any such thing.

>look
Official Office
Portraits of stern old white men hang on the walls, a huge candelier hangs down from the ceiling the the middle of the room. A huge dark wooden desk sits in front of your chair.

Your senior advisor, Martin Gavell, stands patiently in front of your desk.

* * *

>1
[Just grunt.]

You grunt to indicate that he can continue.

Gavell: "Here you are, Sir."

Gavell gives the bill to you.

Official Office
Portraits of stern old white men hang on the walls, a huge candelier hangs down from the ceiling the the middle of the room. A huge dark wooden desk sits in front of your chair.

Your senior advisor, Martin Gavell, stands patiently in front of your desk.

You have possession of the healthcare bill.

>sign the bill
------

TODAY'S NEWSPAPER FRONT PAGE

Notable Healthcare Bill Passes

In a surprising move, the country's new leader has passed the much debated healthcare bill. The passing of the bill has been welcomed by many opposing politicians, however there seems to be some dissatisfaction from the premier's core voter base.

The shaking of the foundations of the Head of State's support has taken its toll. According to our latest calculations, his political power has dipped to 4/5 stars, moreover, his latest actions have raised questions around what this man really stands for. Perhaps this recent change of heart is the beginning of something much greater. Only time will tell.

------

You look over your office once again. Portraits of stern old white men hang on the walls, a huge candelier hangs down from the ceiling the the middle of the room. A huge dark wooden desk sits in front of your chair.

I beg your pardon?

>look up
You see nothing unexpected in that direction.

I beg your pardon?

* * *

>undo
Official Office
[Previous turn undone.]

>destroy the bill
Violence isn't the answer to this one.

* * *

>eat the bill
You momentarily pause as you decide exactly what you want to do.

1) Reject the bill.
2) Destroy the bill.
3) Destroy the bill with extreme prejudice.

>3
 ------

TODAY'S NEWSPAPER FRONT PAGE

Premier Spits on the Poor Leaks from inside the the office of our new leader suggest that he may have gone as far as spitting on the recent healthcare bill whilst refusing to sign it in a fit of rage.

These leaks, which may yet transpire to be entirely false, have already damaged the new Head of State. According to our latest calculations, his political power has sunk to 4/5 stars, and there may be more fallout in store for him.

------ 
Official Office
Portraits of stern old white men hang on the walls, a huge candelier hangs down from the ceiling the the middle of the room. A huge dark wooden desk sits in front of your chair.

Your senior advisor, Martin Gavell, stands patiently in front of your desk.

* * *

>1
[Just grunt.]

You grunt to indicate that he can continue.

Gavell: "Here you are, Sir."

Gavell gives the bill to you.

Official Office
Portraits of stern old white men hang on the walls, a huge candelier hangs down from the ceiling the the middle of the room. A huge dark wooden desk sits in front of your chair.

Your senior advisor, Martin Gavell, stands patiently in front of your desk.

You have possession of the healthcare bill.

>talk to martin
Gavell: "You need to decide what to do with the healthcare bill, Sir."

I beg your pardon?

* * *

>talk to martin
Gavell: "You need to decide what to do with the healthcare bill, Sir."

>sign the bill
 ------

TODAY'S NEWSPAPER FRONT PAGE

Notable Healthcare Bill Passes In a surprising move, the country's new leader has passed the much debated healthcare bill. The passing of the bill has been welcomed by many opposing politicians, however there seems to be some dissatisfaction from the premier's core voter base.

The shaking of the foundations of the Head of State's support has taken its toll. According to our latest calculations, his political power has sunk to 5/5 stars, moreover, his latest actions have raised questions around what this man really stands for.

------

* * *

>talk to martin
You nod to Gavell.

Gavell: "Sir, the healthcare bill requires your attention."

1) Just grunt.
2) Ask for the bill.

>2
[Ask for the bill.]

You: "Hand it over, Gavell."

Gavell: "Here you are, Sir."

Gavell gives the bill to you.

Official Office
Your office probably doesn't look much different now to how it did when each of your predecessors occupied it over the last century.

Portraits of stern old white men hang on the walls, a huge candelier hangs down from the ceiling the the middle of the room. A huge dark wooden desk sits in front of your chair.

The things some men have done to make it to this room...

Your senior advisor, Martin Gavell, stands patiently in front of your desk.

>eat the bill
I only understood you as far as wanting to eat the chair of the head of state.

>inventory
You are carrying nothing.