------

TODAY'S NEWSPAPER FRONT PAGE

In a shocking last minute swing, the country voted for a candidate who, only days ago, looked to be almost totally unelectable. The candidate only recently entered politics and belongs to a fringe party which has never previously garnered more than a few percent of the vote.

Politics isn't what it once was. These are volatile times and the people are eager for a leader who can change things. It's not clear what the voters want - it's not even clear that *they* know what they want - but it's clear the status quo is not it.

Thanks to his landslide victory, the new Head of State currently has a political power of 5/5 stars, according to our new rating. Be sure to follow this number throughout his sure-to-be "exciting" tenure!

------

You stand looking out of the window.

So here we are. You are the new Head of State who has had a meteoric rise to the highest office in the land, but the will of the people is a fickle thing, and you are no run-of-the-mill politican. Scandles are popping up left, right and centre; your staff are leaking damaging comments; the established parties hate you; the media is lapping it up.

You're going to have to work hard if you want to stay in power: It's already beginning to slip through your fingers...

Head of State
An Interactive Fiction by Tom Davies
Release 1 / Serial number 170729 / Inform 7 build 6M62 (I6/v6.33 lib 6/12N) SD

Official Office
Your office probably doesn't look much different now to how it did when each of your predecessors occupied it over the last century.

Portraits of stern old white men hang on the walls, a huge candelier hangs down from the ceiling the the middle of the room. A huge dark wooden desk sits in front of your chair.

The things some men have done to make it to this room...

Your senior advisor, Martin Gravell, stands patiently in front of your desk.

I beg your pardon?

* * *

>check political power
You can't see any such thing.

* * *

>examine Gravell
Gravell is your right-hand man. He's loyal and he knows how to keep his mouth shut.

You nod to Gravell.

Gravell: "Sir, the healthcare bill requires your attention"

1) Just grunt.
2) Ask him to continue.

>1
[Just grunt.]

You grunt.

* * *

>examine Gravell
Gravell is your right-hand man. He's loyal and he knows how to keep his mouth shut.

You nod to Gravell.

Gravell: "Sir, the healthcare bill requires your attention"

1) Just grunt.
2) Ask him to continue.

>2
[Ask him to continue.]

You: "Go ahead, Gravell."

I beg your pardon?

* * *

>examine gravell
Gravell is your right-hand man. He's loyal and he knows how to keep his mouth shut.

You nod to Gravell.

Gravell: "Sir, the healthcare bill requires your attention"

I beg your pardon?

* * *

>examine gravell
Gravell is your right-hand man. He's loyal and he knows how to keep his mouth shut.

You nod to Gravell.

Gravell: "Sir, the healthcare bill requires your attention"

>1
[Just grunt.]

You grunt to indicate that he can continue.

* * *

>examine gravell
Gravell is your right-hand man. He's loyal and he knows how to keep his mouth shut.

You nod to Gravell.

Gravell: "Sir, the healthcare bill requires your attention"

>look at gravell
Gravell is your right-hand man. He's loyal and he knows how to keep his mouth shut.

* * *

>examine kletter
You can't see any such thing.

* * *

>examine martin gravell
Gravell is your right-hand man. He's loyal and he knows how to keep his mouth shut.

* * *

>examine myself
A droopy face, too much makeup, a bit on the heavy side. Not that you are willing to acknowledge any of the negatives. You're important. You've always been important. If someone disagrees with you they must be wrong - and your expression shows it.

* * *

>examine portait
You can't see any such thing.

* * *

>examine portrait
These are the people who led this country since its foundation over one hundred years ago. I'm better and smarter than them.

* * *

>examine the bill
It's an offical document. A bill that needs your approval if it is to survive. Something about funding for healthcare for the poorest and most needy citizens of this great country: Not something you are known for supporting.

* * *

>look at gravell
Gravell is your right-hand man. He's loyal and he knows how to keep his mouth shut.

You nod to Gravell.

Gravell: "Sir, the healthcare bill requires your attention"

1) Just grunt.

* * *

>take desk
That's hardly portable.